1
101010101010101
101010101010101
111010101010111
111010101010111
101110101011101
101110101011101
101011101110101
101011101110101
101010111010101
101010111010101
101010101010101
101010101010101
@
2
000000000001111
000000000011111
000000000111111
000000001111111
000000011111111
000000111111111
000001111111111
000011111111111
000111111111111
001111111111111
011111111111111
111111111111111
@
3
111111100111111
111111001111111
111111100111111
111111001111111
111111100111111
111111001111111
111111100111111
111111001111111
111111100111111
111111001111111
111111100111111
111111001111111
@
4
111111111111111
111111111111111
110000000000011
110111111111011
110111111111011
110111111111011
110111111111011
110111111111011
110111111111011
110000000000011
111111111111111
111111111111111
@
5
111111111111111
100000000000001
101111111111101
101111111111101
101100000001101
101101111101101
101101000001101
101101111111101
101101111111101
101100000000001
101111111111111
101111111111111
@
6
000000111001100
000001111101100
000011111111100
000111111111100
001111111111100
011111111111110
001111111111100
001000111000100
001000111000100
001000111000100
001111111111100
001111111111100
@
7
111111111111111
100000010000001
101111010111101
101111010111101
100000010000001
111111111111111
111111111111111
100000010000001
101111010111101
101111010111101
100000010000001
111111111111111
@
8
001111111111100
011111111111110
110000111000011
110110111011011
110110111011011
111111111111111
111111111111111
100000000000001
110000000000011
111000000000111
011100000001110
001111111111100
@
9
000110000011000
001111000111100
011111101111110
111111111111111
111111111111111
011111111111110
001111111111100
000111111111000
000011111110000
101001111100000
010000111001010
000000010000100
@
10
010101010101010
101010101010101
010101010101010
101010101010101
010101010101010
101010101010101
010101010101010
101010101010101
010101010101010
101010101010101
010101010101010
101010101010101